############################
#............##............#
#.####.#####.##.#####.####.#
#.####.#####.##.#####.####.#
#.####.#####.##.#####.####.#
#..........................#
#.####.##.########.##.####.#
#.####.##.########.##.####.#
#......##....##....##......#
#.####.#####.##.#####.####.#
#.####.#####.##.#####.####.#
#......##..........##......#
######.##.########.##.######
######.##.########.##.######
..........########..........
######.##.########.##.######
######.##.########.##.######
######.##..........##.######
######.##.########.##.######
######.##.########.##.######
#............##............#
#.####.#####.##.#####.####.#
#...##.#####.##.#####.##...#
###.##................##.###
###.##.##.########.##.##.###
#......##....##....##......#
#.##########.##.##########.#
#.##########.##.##########.#
#..........................#
############################